####################
#     #  M     #   #
####  #  ####  # # #
#2 #     #  #    # #
#  #######  ###### #
#                  #
###### # ####### # #
#  M # #     #   # #
# ## # ### # # ### #
# #    #   # #     #
# ###### ### ##### #
#          #     # #
# #### ### ######  #
#       #         C#
##### # ### ## # # #
#   # #      # # # #
# # ### #### # ### #
# #     #    #     #
# ###### # #######A#
####################