####################
#     #    1   #   #
####  #  ####  # # #
#  #     #  #    # #
#  #######  ###### #
#                  #
###### # ####### # #
#    # #     #   # #
# ## # ### # # ### #
# #    #   # #B    #
# ###### ### ##### #
#          #       #
# #### ### ###### ##
#       #         T#
##### # ### #### ###
#   # #      # # # #
# # ### #### # ### #
# #     #    #     #
# ###### # #######2#
####################
