####################
#D    #        #   #
####  #  ####  # # #
#  #     #  #    # #
#M #######  ###### #
#                  #
###### # ####### # #
#    # #     #   # #
# ## # ### # # ### #
# #    #   # #     #
# ###### ### ##### #
#      E   #     # #
# #### ### ###### ##
#       #          #
##### # ### ## # # #
#   # #      # # # #
# # ### #### # ### #
# #     #    #     #
# ###### # #######1#
####################
