####################
#D    #   C    E  #
# ####### ####### #
# B       #      A#
####################
